11111111111111111111
13000100000000000001
11110100000000000001
10000100000000000001
11110100000000000001
10000111110000000011
10000110010000100001
10000110010201100001
10000110011111000001
10000000000000000001
11111111111111111111