1111111111111111111111111111111111111111
1200000001000000000000000000000000000001
1111111101000000000000000000000000000001
1000000101000000000000000000000000000001
1000000101000000000000000000000000000001
1000000001000000000000000000000000000001
1111111101000000000000000000000000000001
1000000001111111111111111111111111111111
1000000000000000000000000000001000000001
1111111111111110000000000000001000000001
1000000001000010000000000000001000000001
100000000100001000000000000000011111!111
1000000001001111111111111111110000000001
1000000001001000000010000000010000000001
1000000001001000000010000000110000000001
1000000001001000000010000000000000000001
1000000001111111111111111111111111111101
1000000000000000010000001000000000000001
1000000000000000010000000000000000000031
1111111111111111111111111111111111111111